  XXXXXX
  XCCCCX
  X  CCX
XXXEEXXXXX
X E   E PX
X   E E  X
XXX   XXXX
  XXXXX