 XXXXXXXX
XXCCX   X
X CCX E XX
X P E  E X
XXEXXX   X
 X     XXX
 XXXXXXX