XXXXXXXXX
XCCCCC  X
XXX E X XX
  X EXX  X
  XE E E X
  X   X  X
  XX  X PX
   XXXXXXX